00000000000000000000
0                  0
0                  0
0        3         0
0   22       22    0
0   22       22    0
0                  0
0                  0
0       3  3       0
0                  0
0 3             3  0
0       3  3       0
0                  0
0                  0
0                  0
0   11      11     0
0   11   3  11     0
0                  0
0                  0
00000000000000000000
