00000000000000000000
0                  0
0                  0
0        4         0
0   22       22    0
0   22       22    0
0                  0
0                  0
0       8  9       0
0                  0
0 3             5  0
0       7          0
0                  0
0                  0
0                  0
0   11      11     0
0   11   6  11     0
0                  0
0                  0
00000000000000000000
