000000000000
0          0
0          0
0  2   2   0
0          0
0          0
0    1     0
0          0
0 3    7   0
0          0
0          0
000000000000