0000000000000000
0  1111     4  0
0              0
0              0
0              0
0          22  0
0      8   22  0
0 7            0
0              0
0              0
0              0
0     2222     0
0              0
011          110
0111    3   1110
0000000000000000